1111111111111111111111111111111111111111111
100000P01110000000000000000000E000111111111
1000000000000000000000000000000000000000001
100111100000000000000C000000000000000000001
10000000000000000000000000000000000C0000001
1000000000000000000000000000000000000000001
1000000000111110000000100000000000000000001
1000000000000000000000100000000111100000001
10000C0000000000000000100000000000000000001
100000C000000000000000C00000000000000000001
1111111111111111111111111111111111111111111